#====================================================#
#....................................................#
#....................................................#
#..##..##..##..##..##..##..##..##..##..##..##..##....#
#..##..##..##..##..##..##..##..##..##..##..##..##....#
#..##..##..##..##..##..##..##..##..##..##..##..##....#
#..##..##..##..##..##..##..##..##..##..##..##..##....#
#..##..##..##..##..##..##..##..##..##..##..##..##....#
#..##..##..##..##..##..##..##..##..##..##..##..##....#
#..==..==..==..==..==..==..==..==..==..==..==..==....#
#..==..==..==..==..==..==..==..==..==..==..==..==....#
#....................................................#
#....................................................#
#..##..##..##..##..##..##..##..##..##..##..##..##....#
#..##..##..##..##..##..##..##..##..##..##..##..##....#
#..##..##..##..##..##..##..##..##..##..##..##..##....#
#..##..##..##..##..##..##..##..##..##..##..##..##....#
#..##..##..##..##..##..##..##..##..##..##..##..##....#
#..==..==..##..##..##..##..##..##..##..##..##..##....#
#..==..==..==..==..==..==..==..==..==..==..==..==....#
#..........==..==..==..==..==..==..==..==..==..==....#
#....................................................#
#...###..............................................#
#...=.=..............................................#
##..##################################################
